1_1_12,1_1_12,1_1_12,1_1_12,1_1_12,1_1_1,1_1_1,1_1_1,1_1_1,1_1_1,1_1_1,1_1_1,1_1_1,1_1_1,1_1_1,1_1_1,
1_1_12,1_1_12,1_1_12,1_1_12,1_1_12,1_1_12,1_1_1,1_1_1,1_1_1,1_1_1,1_1_1,1_1_1,1_1_1,1_1_1,1_1_1,1_1_1,
1_1_12,1_1_12,1_1_12,1_1_12,1_1_12,1_1_12,1_1_1,1_1_1,1_1_1,1_1_1,1_1_1,1_1_1,1_1_1,1_1_1,1_1_1,1_1_1,
1_1_12,1_1_12,1_1_12,1_1_12,1_1_12,1_1_12,1_1_1,1_1_1,1_1_1,1_1_1,1_1_1,1_1_1,1_1_1,1_1_1,1_1_1,1_1_1,
1_1_12,1_1_12,1_1_12,1_1_12,1_1_12,1_1_12,1_1_1,1_1_1,1_1_1,1_1_1,1_1_1,1_1_1,1_1_1,1_1_1,1_1_1,1_1_1,
1_1_12,1_1_12,1_1_12,1_1_12,1_1_12,1_1_12,1_1_1,1_1_1,1_1_1,1_1_1,1_1_1,1_1_1,1_1_1,1_1_1,1_1_1,1_1_1,
1_1_12,1_1_12,1_1_12,1_1_12,1_1_12,1_1_1,1_1_1,1_1_1,1_1_1,1_1_1,1_1_1,1_1_1,1_1_1,1_1_1,1_1_1,1_1_1,
1_1_12,1_1_12,1_1_12,1_1_12,1_1_1,1_1_1,1_1_1,1_1_1,1_1_1,1_1_1,1_1_1,1_1_1,1_1_1,1_1_1,1_1_1,1_1_1,
1_1_13,1_1_13,1_1_13,1_1_13,1_1_13,1_1_1,1_1_1,1_1_1,1_1_1,1_1_1,1_1_1,1_1_1,1_1_1,1_1_1,1_1_1,1_1_1,
1_1_13,1_1_13,1_1_13,1_1_13,1_1_13,1_1_13,1_1_1,1_1_1,1_1_1,1_1_1,1_1_1,1_1_1,1_1_1,1_1_1,1_1_1,1_1_1,
1_1_13,1_1_13,1_1_13,1_1_13,1_1_13,1_1_13,1_1_13,1_1_1,1_1_1,1_1_1,1_1_1,1_1_1,1_1_1,1_1_1,1_1_1,1_1_1,
1_1_13,1_1_13,1_1_13,1_1_13,1_1_13,1_1_13,1_1_13,1_1_1,1_1_1,1_1_1,1_1_1,1_1_1,1_1_1,1_1_1,1_1_1,1_1_1,
1_1_13,1_1_13,1_1_13,1_1_13,1_1_13,1_1_13,1_1_13,1_1_1,1_1_1,1_1_1,1_1_1,1_1_1,1_1_1,1_1_1,1_1_1,1_1_7,
1_1_13,1_1_13,1_1_13,1_1_13,1_1_13,1_1_13,1_1_13,1_1_1,1_1_1,1_1_1,1_1_1,1_1_1,1_1_1,1_1_1,1_1_7,1_1_7,
1_1_13,1_1_13,1_1_13,1_1_13,1_1_13,1_1_13,1_1_13,1_1_1,1_1_1,1_1_1,1_1_1,1_1_1,1_1_1,1_1_1,1_1_7,1_1_7,
1_1_13,1_1_13,1_1_13,1_1_13,1_1_13,1_1_13,1_1_1,1_1_1,1_1_1,1_1_1,1_1_1,1_1_1,1_1_1,1_1_1,1_1_1,1_1_7,
