1_1_1,1_1_1,1_1_1,1_1_1,1_1_1,1_1_10,1_1_1,1_1_1,1_1_1,1_1_11,1_1_11,1_1_11,1_1_10,1_1_10,1_1_1,1_1_1,
1_1_1,1_1_1,1_1_1,1_1_1,1_1_1,1_1_1,1_1_1,1_1_1,1_1_12,1_1_11,1_1_11,1_1_10,1_1_10,1_1_10,1_1_10,1_1_1,
1_1_10,1_1_10,1_1_10,1_1_10,1_1_1,1_1_1,1_1_1,1_1_11,1_1_12,1_1_11,1_1_11,1_1_10,1_1_10,1_1_10,1_1_11,1_1_1,
1_1_11,1_1_12,1_1_11,1_1_10,1_1_1,1_1_1,1_1_1,1_1_11,1_1_15,1_1_11,1_1_11,1_1_11,1_1_10,1_1_15,1_1_15,1_1_1,
1_1_11,1_1_11,1_1_12,1_1_10,1_1_1,1_1_1,1_1_1,1_1_12,1_1_11,1_1_11,1_1_11,1_1_11,1_1_15,1_1_15,1_1_11,1_1_1,
1_1_11,1_1_11,1_1_11,1_1_11,1_1_1,1_1_1,1_1_12,1_1_12,1_1_1,1_1_11,1_1_11,1_1_11,1_1_15,1_1_1,1_1_1,1_1_1,
1_1_11,1_1_11,1_1_11,1_1_1,1_1_1,1_1_1,1_1_1,1_1_12,1_1_11,1_1_11,1_1_11,1_1_11,1_1_15,1_1_1,1_1_1,1_1_1,
1_1_12,1_1_11,1_1_15,1_1_1,1_1_1,1_1_1,1_1_1,1_1_11,1_1_11,1_1_12,1_1_11,1_1_15,1_1_11,1_1_15,1_1_1,1_1_1,
1_1_11,1_1_11,1_1_11,1_1_15,1_1_11,1_1_1,1_1_1,1_1_11,1_1_11,1_1_11,1_1_15,1_1_11,1_1_11,1_1_11,1_1_1,1_1_1,
1_1_11,1_1_12,1_1_11,1_1_11,1_1_11,1_1_15,1_1_11,1_1_12,1_1_11,1_1_15,1_1_11,1_1_11,1_1_11,1_1_15,1_1_1,1_1_11,
1_1_11,1_1_11,1_1_11,1_1_11,1_1_11,1_1_1,1_1_11,1_1_11,1_1_11,1_1_11,1_1_11,1_1_11,1_1_11,1_1_15,1_1_11,1_1_11,
1_1_11,1_1_11,1_1_11,1_1_11,1_1_1,1_1_1,1_1_12,1_1_11,1_1_11,1_1_11,1_1_11,1_1_11,1_1_11,1_1_11,1_1_11,1_1_11,
1_1_11,1_1_11,1_1_11,1_1_11,1_1_1,1_1_1,1_1_1,1_1_11,1_1_11,1_1_11,1_1_11,1_1_11,1_1_11,1_1_11,1_1_11,1_1_11,
1_1_11,1_1_11,1_1_11,1_1_11,1_1_1,1_1_1,1_1_1,1_1_11,1_1_11,1_1_11,1_1_11,1_1_11,1_1_11,1_1_11,1_1_11,1_1_11,
1_1_1,1_1_11,1_1_1,1_1_1,1_1_1,1_1_1,1_1_1,1_1_1,1_1_11,1_1_11,1_1_11,1_1_11,1_1_11,1_1_11,1_1_11,1_1_11,
1_1_1,1_1_1,1_1_1,1_1_1,1_1_1,1_1_11,1_1_1,1_1_11,1_1_11,1_1_11,1_1_11,1_1_11,1_1_11,1_1_11,1_1_11,1_1_11,
