1_1_1,1_1_1,1_1_1,1_1_1,1_1_1,1_1_1,1_1_1,1_1_1,1_1_1,1_1_1,1_1_1,1_1_1,1_1_1,1_1_1,1_1_3,1_1_3,
1_1_1,1_1_1,1_1_1,1_1_1,1_1_1,1_1_1,1_1_1,1_1_1,1_1_3,1_1_3,1_1_3,1_1_3,1_1_3,1_1_3,1_1_3,1_1_3,
1_1_3,1_1_3,1_1_4,1_1_3,1_1_3,1_1_3,1_1_3,1_1_3,1_1_1,1_1_4,1_1_4,1_1_4,1_1_4,1_1_4,1_1_4,1_1_3,
1_1_3,1_1_4,1_1_4,1_1_4,1_1_4,1_1_4,1_1_4,1_1_3,1_1_3,1_1_3,1_1_3,1_1_4,1_1_3,1_1_4,1_1_4,1_1_4,
1_1_3,1_1_3,1_1_3,1_1_4,1_1_4,1_1_4,1_1_3,1_1_4,1_1_4,1_1_3,1_1_4,1_1_3,1_1_3,1_1_3,1_1_3,1_1_3,
1_1_3,1_1_3,1_1_3,1_1_3,1_1_3,1_1_3,1_1_3,1_1_3,1_1_3,1_1_3,1_1_3,1_1_3,1_1_3,1_1_3,1_1_3,1_1_1,
1_1_1,1_1_3,1_1_3,1_1_3,1_1_3,1_1_3,1_1_3,1_1_3,1_1_1,1_1_1,1_1_1,1_1_1,1_1_1,1_1_1,1_1_1,1_1_1,
1_1_1,1_1_1,1_1_1,1_1_1,1_1_1,1_1_1,1_1_1,1_1_1,1_1_1,1_1_1,1_1_1,1_1_1,1_1_1,1_1_1,1_1_1,1_1_11,
1_1_1,1_1_1,1_1_1,1_1_1,1_1_1,1_1_1,1_1_1,1_1_1,1_1_1,1_1_1,1_1_1,1_1_11,1_1_1,1_1_11,1_1_11,1_1_11,
1_1_1,1_1_11,1_1_11,1_1_1,1_1_11,1_1_11,1_1_11,1_1_11,1_1_1,1_1_11,1_1_11,1_1_11,1_1_11,1_1_11,1_1_11,1_1_11,
1_1_11,1_1_11,1_1_11,1_1_11,1_1_11,1_1_11,1_1_11,1_1_11,1_1_11,1_1_11,1_1_11,1_1_11,1_1_1,1_1_11,1_1_11,1_1_1,
1_1_1,1_1_11,1_1_11,1_1_1,1_1_11,1_1_11,1_1_11,1_1_11,1_1_1,1_1_11,1_1_1,1_1_1,1_1_1,1_1_1,1_1_1,1_1_1,
1_1_1,1_1_1,1_1_1,1_1_1,1_1_1,1_1_1,1_1_1,1_1_1,1_1_1,1_1_1,1_1_1,1_1_1,1_1_1,1_1_1,1_1_1,1_1_1,
1_1_1,1_1_1,1_1_1,1_1_1,1_1_1,1_1_1,1_1_1,1_1_1,1_1_1,1_1_1,1_1_1,1_1_1,1_1_1,1_1_1,1_1_1,1_1_1,
1_1_1,1_1_1,1_1_1,1_1_1,1_1_1,1_1_1,1_1_1,1_1_1,1_1_1,1_1_1,1_1_1,1_1_1,1_1_1,1_1_1,1_1_1,1_1_1,
1_1_1,1_1_1,1_1_1,1_1_1,1_1_1,1_1_1,1_1_1,1_1_1,1_1_1,1_1_1,1_1_1,1_1_1,1_1_1,1_1_1,1_1_1,1_1_1,
