1_1_1,1_1_1,1_1_1,1_1_1,1_1_1,1_1_1,1_1_1,1_1_1,1_1_7,1_1_7,1_1_1,1_1_1,1_1_9,1_1_11,1_1_11,1_1_11,
1_1_9,1_1_9,1_1_9,1_1_1,1_1_1,1_1_1,1_1_1,1_1_7,1_1_7,1_1_7,1_1_7,1_1_1,1_1_1,1_1_9,1_1_11,1_1_11,
1_1_9,1_1_9,1_1_9,1_1_9,1_1_1,1_1_1,1_1_1,1_1_7,1_1_7,1_1_7,1_1_1,1_1_1,1_1_9,1_1_11,1_1_11,1_1_11,
1_1_9,1_1_9,1_1_9,1_1_9,1_1_9,1_1_1,1_1_1,1_1_1,1_1_7,1_1_1,1_1_1,1_1_1,1_1_1,1_1_11,1_1_11,1_1_11,
1_1_9,1_1_9,1_1_9,1_1_9,1_1_9,1_1_1,1_1_1,1_1_7,1_1_7,1_1_7,1_1_1,1_1_1,1_1_11,1_1_11,1_1_11,1_1_11,
1_1_9,1_1_9,1_1_9,1_1_9,1_1_9,1_1_1,1_1_1,1_1_1,1_1_7,1_1_7,1_1_1,1_1_9,1_1_9,1_1_11,1_1_11,1_1_11,
1_1_9,1_1_9,1_1_9,1_1_9,1_1_9,1_1_1,1_1_1,1_1_1,1_1_7,1_1_7,1_1_7,1_1_9,1_1_9,1_1_9,1_1_11,1_1_11,
1_1_9,1_1_9,1_1_9,1_1_9,1_1_9,1_1_1,1_1_1,1_1_1,1_1_1,1_1_7,1_1_1,1_1_1,1_1_9,1_1_9,1_1_1,1_1_9,
1_1_9,1_1_9,1_1_9,1_1_9,1_1_1,1_1_1,1_1_1,1_1_1,1_1_1,1_1_1,1_1_1,1_1_1,1_1_1,1_1_1,1_1_1,1_1_9,
1_1_9,1_1_9,1_1_9,1_1_1,1_1_1,1_1_1,1_1_1,1_1_1,1_1_1,1_1_1,1_1_1,1_1_1,1_1_1,1_1_7,1_1_1,1_1_7,
1_1_10,1_1_10,1_1_10,1_1_10,1_1_10,1_1_1,1_1_1,1_1_1,1_1_1,1_1_1,1_1_1,1_1_1,1_1_7,1_1_7,1_1_7,1_1_1,
1_1_10,1_1_10,1_1_10,1_1_10,1_1_10,1_1_10,1_1_1,1_1_1,1_1_1,1_1_1,1_1_1,1_1_1,1_1_7,1_1_7,1_1_7,1_1_7,
1_1_10,1_1_10,1_1_10,1_1_10,1_1_10,1_1_10,1_1_10,1_1_1,1_1_1,1_1_1,1_1_1,1_1_1,1_1_1,1_1_7,1_1_7,1_1_7,
1_1_10,1_1_10,1_1_10,1_1_10,1_1_10,1_1_10,1_1_10,1_1_1,1_1_1,1_1_1,1_1_1,1_1_1,1_1_1,1_1_1,1_1_1,1_1_7,
1_1_10,1_1_10,1_1_10,1_1_10,1_1_10,1_1_10,1_1_10,1_1_1,1_1_1,1_1_1,1_1_1,1_1_1,1_1_1,1_1_1,1_1_1,1_1_1,
1_1_10,1_1_10,1_1_10,1_1_10,1_1_10,1_1_10,1_1_10,1_1_1,1_1_1,1_1_1,1_1_1,1_1_1,1_1_1,1_1_1,1_1_1,1_1_1,
