1_1_1,1_1_1,1_1_1,1_1_1,1_1_1,1_1_1,1_1_1,1_1_1,1_1_1,1_1_1,1_1_1,1_1_1,1_1_1,1_1_1,1_1_1,1_1_1,
1_1_1,1_1_1,1_1_1,1_1_1,1_1_1,1_1_1,1_1_1,1_1_1,1_1_1,1_1_1,1_1_1,1_1_1,1_1_1,1_1_1,1_1_9,1_1_9,
1_1_1,1_1_1,1_1_1,1_1_1,1_1_1,1_1_1,1_1_1,1_1_1,1_1_1,1_1_1,1_1_1,1_1_1,1_1_1,1_1_9,1_1_9,1_1_9,
1_1_1,1_1_1,1_1_1,1_1_1,1_1_1,1_1_1,1_1_1,1_1_1,1_1_1,1_1_1,1_1_1,1_1_1,1_1_9,1_1_9,1_1_9,1_1_9,
1_1_1,1_1_1,1_1_1,1_1_1,1_1_1,1_1_1,1_1_1,1_1_1,1_1_1,1_1_1,1_1_1,1_1_1,1_1_9,1_1_9,1_1_9,1_1_9,
1_1_1,1_1_1,1_1_1,1_1_1,1_1_1,1_1_1,1_1_1,1_1_1,1_1_1,1_1_1,1_1_1,1_1_1,1_1_9,1_1_9,1_1_9,1_1_9,
1_1_1,1_1_1,1_1_1,1_1_1,1_1_1,1_1_1,1_1_1,1_1_1,1_1_1,1_1_1,1_1_1,1_1_1,1_1_9,1_1_9,1_1_9,1_1_9,
1_1_1,1_1_1,1_1_1,1_1_1,1_1_1,1_1_1,1_1_1,1_1_1,1_1_1,1_1_1,1_1_1,1_1_1,1_1_9,1_1_9,1_1_9,1_1_9,
1_1_1,1_1_1,1_1_1,1_1_1,1_1_1,1_1_1,1_1_1,1_1_1,1_1_1,1_1_1,1_1_1,1_1_1,1_1_1,1_1_9,1_1_9,1_1_9,
1_1_1,1_1_1,1_1_1,1_1_1,1_1_1,1_1_1,1_1_1,1_1_1,1_1_1,1_1_1,1_1_1,1_1_1,1_1_1,1_1_1,1_1_9,1_1_9,
1_1_1,1_1_1,1_1_1,1_1_1,1_1_1,1_1_1,1_1_1,1_1_1,1_1_1,1_1_1,1_1_1,1_1_1,1_1_1,1_1_1,1_1_1,1_1_1,
1_1_1,1_1_1,1_1_1,1_1_1,1_1_1,1_1_2,1_1_2,1_1_2,1_1_2,1_1_2,1_1_1,1_1_1,1_1_1,1_1_1,1_1_1,1_1_10,
1_1_1,1_1_1,1_1_1,1_1_1,1_1_2,1_1_2,1_1_2,1_1_2,1_1_2,1_1_2,1_1_2,1_1_1,1_1_1,1_1_1,1_1_10,1_1_10,
1_1_1,1_1_1,1_1_1,1_1_2,1_1_2,1_1_2,1_1_2,1_1_2,1_1_2,1_1_2,1_1_2,1_1_2,1_1_1,1_1_1,1_1_10,1_1_10,
1_1_1,1_1_1,1_1_1,1_1_2,1_1_2,1_1_2,1_1_2,1_1_2,1_1_2,1_1_2,1_1_2,1_1_2,1_1_1,1_1_1,1_1_10,1_1_10,
1_1_1,1_1_1,1_1_1,1_1_2,1_1_2,1_1_2,1_1_2,1_1_2,1_1_2,1_1_2,1_1_2,1_1_2,1_1_1,1_1_1,1_1_10,1_1_10,
